job,operation,machine,process_time,start_time,end_time,job_duration
"1.2",1,1,4,0,4,18
"1.2",2,2,4,4,8,18
"1.2",3,3,5,8,13,18
"1.2",4,4,5,13,18,18
"2.2",1,3,3,0,3,39
"2.2",2,2,4,8,12,39
"2.2",3,3,6,13,19,39
"2.2",4,4,4,19,23,39
"2.2",5,4,6,23,29,39
"2.2",6,6,6,29,35,39
"2.2",7,4,4,35,39,39
"3.3",1,8,8,0,8,50 
"3.3",2,8,8,8,16,50
"3.3",3,7,7,19,26,50
"3.3",4,4,7,39,46,50
"3.3",5,2,4,46,50,50
"ola",1,7,2,0,2,2